111111111111
100D00010001
10000C000001
1000E0001001
111111111111
