1111111111111
100100000C001
1000011111E01
1P0011E000001
1111111111111
