1111111111111111
10000000C00000P1
1001011111000001
10010000C0000P01
1001000000000E01
10001111101100C1
1111111111111111
